Level,item_number,reference_designator,Quantity
0,830-00026,none,1
1,120-00002,"C18, C19",2
1,145-00003,F1,1
1,125-00087,P1,1
1,125-00104,P2,1
1,125-00054,P3,1
1,195-00004,Q1,1
1,185-00010,S1,1
1,160-00001,"TP1, TP2",2
1,150-00083,U8,1
1,150-00076,U9,1
1,150-00030,U10,1
1,450-00001,PCB_Bottom,4
1,175-00033,BarePCB,1
